##############    ##############
#............#   R#............#
#............######............################################
#......u.....|....|.......R....|..............................#
#............######............################################
#............#    #............#            
##############    ##############            
