##############    ##############
#............#   R#............#
#..@.........######............################################
#............|....|.......R....|..............................#
#............######............###############|################
#............#    #............#            #...#
##############    ###..#########            #...#
                    #..#                    #...#
                    #..#                    #...#
                    #..#                    #...#
                    #..#                    #...#
                    #..#                    #...#
                    #..#                    #...#
                    #..#                    #...#
                    #..#                    #...#
                    #..#                    #...#
                    #..#                    #...#
#####################..######################...############################
#....................................#.....................................#
#....................................#.....................................#
#.........................S..........#.....................................#
#....................................|....................S................#
#....................................#.....................................#
#....................................#.....................................#
#....................................#.....................................#
############################################################################
