##############    ##############
#............#   R#............#
#............######............################################
#......u.....|....|.......R....|..............................#
#............######............###############|################
#............#    #............#            #...#
##############    ###..#########            #...#
                    #..#                    #...#
                    #..#                    #...#
                    #..#                    #...#
                    #..#                    #...#
                    #..#                    #...#
                    #..#                    #...#
                    #..#                    #...#
                    #..#                    #...#
                    #..#                    #...#
                    #..#                    #...#
#####################..######################...############################
#....................................#.....................................#
#....................................#.....................................#
#....................................#.....................................#
#....................................#.....................................#
#....................................|.....................................#
#....................................#.....................................#
#....................................#.....................................#
#....................................#.....................................#
#....................................#.....................................#
############################################################################
