##############    ##############
#............#    #............#
#............######............################################
#...d....@...|....|.....R.....|..............................#
#............######............###############|################
#...........S#    #............#            #...#
##############    ###..#########            #...#
                    #.S#                    #...#
                    #..#                    #...#
                    #..#                    #...#
                    #..#                    #...#
                    #..#                    #...#
                    #..#                    #...#
                    #..#                    #...#
                    #..#                    #...#
                    #..#                    #...#
                    #..#                    #...#
#####################..######################...############################
#....................................#.....................................#
#....................................#.....................................#
#....................................#.....................................#
#....................................#.....................................#
#....................................|.....................................#
#....................................#.....................................#
#....................................#.....................................#
#....................................#.....................................#
#....................................#.....................................#
############################################################################
